############
#          #
#   .      #
#   ~~~    #
#   $      #
#          #
# @ 5   .  #
#          #
############