###############
#       MMMMM #
# K   C M . M #
#       M   M #
#       MMMMM #
#             #
# @ 5    .    #
#             #
#   $~~~.     #
#             #
###############