###############
#             #
#    .        #
#    ~~~      #
#    $        #
#             #
#  @ 5   .    #
#             #
#             #
###############