##########
#        #
#  ..    #
#  $$    #
#   @    #
#        #
##########