###############
#             #
# K   C M .   #
#       M $   #
#       M     #
#             #
# @ 5    .    #
#             #
#   $~~~.     #
#             #
###############