###############
#             #
#    ..       #
#    $$       #
#     @       #
#             #
#             #
#             #
#             #
###############